NO   src/sprites/ciel.xpm
C                           223,30,0
SO        src/sprites/god_adam.xpm
WE        src/sprites/man.xpm
F                 220,100,0
EA     src/sprites/picasso.xpm

1111111111 111111111
1000000001110000001
10101010100001010111
10000N00000010000001
1111111111111111111

